природа - The beauty of nature is breathtaking. (Красота природы захватывает дух.)
лес - The forest is home to many animals. (Лес является домом для многих животных.)
дерево - The tree provides shade on a sunny day. (Дерево дает тень в солнечный день.)
река - The river flows gently through the valley. (Река течет спокойно через долину.)
гора - The mountain peak was covered in snow. (Вершина горы была покрыта снегом.)
озеро - The lake was calm and serene. (Озеро было спокойным и безмятежным.)
океан - The ocean is vast and mysterious. (Океан огромен и загадочен.)
море - The sea sparkled under the sun. (Море сверкало под солнцем.)
небо - The sky was clear and blue. (Небо было ясным и голубым.)
солнце - The sun rose early in the morning. (Солнце встало рано утром.)
луна - The moon was full and bright. (Луна была полной и яркой.)
звезда - The star twinkled in the night sky. (Звезда мерцала в ночном небе.)
облако - The cloud drifted slowly across the sky. (Облако медленно плыло по небу.)
дождь - The rain fell softly on the roof. (Дождь мягко падал на крышу.)
снег - The snow covered the ground in a white blanket. (Снег покрыл землю белым одеялом.)
ветер - The wind blew through the trees. (Ветер дул сквозь деревья.)
буря - The storm caused widespread damage. (Буря вызвала массовые разрушения.)
молния - Lightning lit up the night sky. (Молния осветила ночное небо.)
гром - Thunder echoed through the valley. (Гром эхом разнесся по долине.)
земля - The earth is rich with nutrients. (Земля богата питательными веществами.)
почва - The soil was perfect for planting. (Почва была идеальной для посадки.)
камень - The rock was smooth and cold. (Камень был гладким и холодным.)
песок - The sand was warm underfoot. (Песок был теплым под ногами.)
трава - The grass was green and lush. (Трава была зеленой и пышной.)
цветок - The flower bloomed in the spring. (Цветок расцвел весной.)
лист - The leaf fell from the tree. (Лист упал с дерева.)
ветка - The branch swayed in the wind. (Ветка качалась на ветру.)
корень - The root anchored the tree firmly. (Корень крепко удерживал дерево.)
кора - The bark of the tree was rough. (Кора дерева была шероховатой.)
дерево - The wood was used to build the house. (Дерево использовали для постройки дома.)
вода - The water was crystal clear. (Вода была кристально чистой.)
лед - The ice cracked under the weight. (Лед треснул под весом.)
огонь - The fire kept us warm. (Огонь согревал нас.)
воздух - The air was fresh and clean. (Воздух был свежим и чистым.)
животное - The animal roamed freely in the wild. (Животное свободно бродило в дикой природе.)
птица - The bird sang a beautiful song. (Птица пела красивую песню.)
рыба - The fish swam gracefully in the water. (Рыба грациозно плавала в воде.)
насекомое - The insect buzzed around the flower. (Насекомое жужжало вокруг цветка.)
пчела - The bee collected nectar from the flower. (Пчела собирала нектар с цветка.)
бабочка - The butterfly fluttered by. (Бабочка порхала мимо.)
муравей - The ant carried a crumb to its nest. (Муравей нес крошку в свое гнездо.)
паук - The spider spun a delicate web. (Паук сплел тонкую паутину.)
змея - The snake slithered through the grass. (Змея скользила по траве.)
лев - The lion roared in the distance. (Лев рычал вдалеке.)
тигр - The tiger prowled through the jungle. (Тигр бродил по джунглям.)
медведь - The bear caught a fish in the river. (Медведь поймал рыбу в реке.)
олень - The deer grazed in the meadow. (Олень пасся на лугу.)
волк - The wolf howled at the moon. (Волк выл на луну.)
лиса - The fox darted into the bushes. (Лиса метнулась в кусты.)
кролик - The rabbit hopped across the field. (Кролик прыгал по полю.)
белка - The squirrel gathered nuts for the winter. (Белка собирала орехи на зиму.)
слон - The elephant trumpeted loudly. (Слон громко трубил.)
жираф - The giraffe reached for the leaves. (Жираф тянулся к листьям.)
зебра - The zebra galloped across the savanna. (Зебра мчалась по саванне.)
обезьяна - The monkey swung from branch to branch. (Обезьяна качалась с ветки на ветку.)
дельфин - The dolphin leaped out of the water. (Дельфин выпрыгнул из воды.)
кит - The whale surfaced for air. (Кит всплыл за воздухом.)
акула - The shark circled the boat. (Акула кружила вокруг лодки.)
черепаха - The turtle crawled onto the shore. (Черепаха выползла на берег.)
лягушка - The frog croaked by the pond. (Лягушка квакала у пруда.)
ящерица - The lizard basked in the sun. (Ящерица грелась на солнце.)
крокодил - The crocodile lay still in the water. (Крокодил лежал неподвижно в воде.)
орел - The eagle soared high above. (Орел парил высоко в небе.)
ястреб - The hawk swooped down on its prey. (Ястреб спикировал на свою добычу.)
сова - The owl hooted in the night. (Сова ухала в ночи.)
ворона - The crow cawed loudly. (Ворона громко каркала.)
воробей - The sparrow chirped in the tree. (Воробей чирикал на дереве.)
пингвин - The penguin waddled on the ice. (Пингвин ковылял по льду.)
фламинго - The flamingo stood on one leg. (Фламинго стоял на одной ноге.)
павлин - The peacock displayed its feathers. (Павлин распустил свои перья.)
попугай - The parrot mimicked human speech. (Попугай имитировал человеческую речь.)
чайка - The seagull flew over the beach. (Чайка летала над пляжем.)
лебедь - The swan glided across the lake. (Лебедь скользил по озеру.)
утка - The duck quacked by the pond. (Утка крякала у пруда.)
гусь - The goose honked loudly. (Гусь громко гоготал.)
цапля - The heron stood still in the water. (Цапля стояла неподвижно в воде.)
журавль - The crane danced in the field. (Журавль танцевал в поле.)
пеликан - The pelican caught a fish. (Пеликан поймал рыбу.)
аист - The stork built a nest on the roof. (Аист построил гнездо на крыше.)
гриф - The vulture circled above. (Гриф кружил вверху.)
сокол - The falcon dived at incredible speed. (Сокол пикировал с невероятной скоростью.)
коршун - The kite flew high in the sky. (Коршун летал высоко в небе.)
ворон - The raven perched on the branch. (Ворон сидел на ветке.)
малиновка - The robin sang at dawn. (Малиновка пела на рассвете.)
синяя птица - The bluebird nested in the tree. (Синяя птица гнездилась на дереве.)
канарейка - The canary sang sweetly. (Канарейка пела сладко.)
зяблик - The finch pecked at the seeds. (Зяблик клевал семена.)
чайка - The gull scavenged for food. (Чайка искала еду.)
ибис - The ibis waded in the marsh. (Ибис бродил по болоту.)
зимородок - The kingfisher caught a fish. (Зимородок поймал рыбу.)
лорикет - The lorikeet fed on nectar. (Лорикет питался нектаром.)
сорока - The magpie collected shiny objects. (Сорока собирала блестящие предметы.)
майна - The myna imitated sounds. (Майна имитировала звуки.)
страус - The ostrich ran across the plain. (Страус бежал по равнине.)
перепел - The quail hid in the grass. (Перепел прятался в траве.)
жаворонок - The skylark sang in the sky. (Жаворонок пел в небе.)
стриж - The swift flew at high speed. (Стриж летел с высокой скоростью.)
крачка - The tern dived into the water. (Крачка нырнула в воду.)
славка - The warbler sang in the bushes. (Славка пела в кустах.)
дятел - The woodpecker pecked at the tree. (Дятел долбил дерево.)
альпака - The alpaca grazed in the field. (Альпака паслась в поле.)
буйвол - The buffalo roamed the plains. (Буйвол бродил по равнинам.)
верблюд - The camel crossed the desert. (Верблюд пересекал пустыню.)
гепард - The cheetah ran at full speed. (Гепард бежал на полной скорости.)
койот - The coyote howled at night. (Койот выл ночью.)
динго - The dingo hunted in the pack. (Динго охотился в стае.)
лось - The elk grazed in the forest. (Лось пасся в лесу.)
горилла - The gorilla beat its chest. (Горилла била себя в грудь.)
еж - The hedgehog curled into a ball. (Еж свернулся в клубок.)
гиена - The hyena laughed in the night. (Гиена смеялась ночью.)
шакал - The jackal scavenged for food. (Шакал искал еду.)
кенгуру - The kangaroo hopped across the field. (Кенгуру прыгал по полю.)
коала - The koala slept in the tree. (Коала спала на дереве.)
леопард - The leopard climbed the tree. (Леопард залез на дерево.)
лама - The llama carried a load. (Лама несла груз.)
сурикат - The meerkat stood guard. (Сурикат стоял на страже.)
лось - The moose waded through the water. (Лось бродил по воде.)
выдра - The otter played in the river. (Выдра играла в реке.)
панда - The panda ate bamboo. (Панда ела бамбук.)
утконос - The platypus swam in the river. (Утконос плавал в реке.)
дикобраз - The porcupine raised its quills. (Дикобраз поднял свои иглы.)
енот - The raccoon washed its food. (Енот мыл свою еду.)
носорог - The rhinoceros charged at the intruder. (Носорог бросился на нарушителя.)
тюлень - The seal basked on the rock. (Тюлень грелся на камне.)
морж - The walrus rested on the ice. (Морж отдыхал на льду.)
вомбат - The wombat dug a burrow. (Вомбат рыл нору.)
як - The yak grazed in the mountains. (Як пасся в горах.)
зебу - The zebu plowed the field. (Зебу пахал поле.)
моллюск - The clam buried itself in the sand. (Моллюск зарылся в песок.)
краб - The crab scuttled sideways. (Краб бежал боком.)
лобстер - The lobster hid in the crevice. (Лобстер прятался в расщелине.)
осьминог - The octopus camouflaged itself. (Осьминог маскировался.)
устрица - The oyster produced a pearl. (Устрица произвела жемчужину.)
креветка - The shrimp swam in the school. (Креветка плавала в стае.)
улитка - The snail left a trail of slime. (Улитка оставляла след слизи.)
морская звезда - The starfish clung to the rock. (Морская звезда цеплялась за камень.)
морской еж - The urchin hid among the rocks. (Морской еж прятался среди камней.)
коралл - The coral reef was teeming with life. (Коралловый риф кишел жизнью.)
водоросли - The algae floated on the water. (Водоросли плавали на воде.)
мох - The moss covered the rock. (Мох покрывал камень.)
папоротник - The fern grew in the shade. (Папоротник рос в тени.)
гриб - The mushroom sprouted after the rain. (Гриб вырос после дождя.)
лишайник - The lichen grew on the tree. (Лишайник рос на дереве.)
плющ - The ivy climbed the wall. (Плющ карабкался по стене.)
лоза - The vine produced grapes. (Лоза давала виноград.)
кактус - The cactus survived in the desert. (Кактус выживал в пустыне.)
пальма - The palm tree swayed in the breeze. (Пальма качалась на ветру.)
бамбук - The bamboo grew rapidly. (Бамбук быстро рос.)
ива - The willow drooped over the water. (Ива склонялась над водой.)
дуб - The oak tree stood tall. (Дуб стоял высоко.)
сосна - The pine tree smelled fresh. (Сосна пахла свежестью.)
клен - The maple tree turned red in autumn. (Клен становился красным осенью.)
береза - The birch tree had white bark. (Береза имела белую кору.)
кедр - The cedar tree was aromatic. (Кедр был ароматным.)
вяз - The elm tree provided shade. (Вяз давал тень.)
пихта - The fir tree was used as a Christmas tree. (Пихта использовалась как рождественская елка.)
ясень - The ash tree had strong wood. (Ясень имел прочную древесину.)
бук - The beech tree had smooth bark. (Бук имел гладкую кору.)
каштан - The chestnut tree produced nuts. (Каштан давал орехи.)
гикори - The hickory tree had hard wood. (Гикори имел твердую древесину.)
лиственница - The larch tree lost its needles. (Лиственница теряла свои иголки.)
махагони - The mahogany tree was prized for its wood. (Махагони ценился за свою древесину.)
тополь - The poplar tree rustled in the wind. (Тополь шелестел на ветру.)
секвойя - The redwood tree was enormous. (Секвойя была огромной.)
ель - The spruce tree was used for lumber. (Ель использовалась для пиломатериалов.)
платан - The sycamore tree had large leaves. (Платан имел большие листья.)
грецкий орех - The walnut tree produced nuts. (Грецкий орех давал орехи.)
тис - The yew tree was evergreen. (Тис был вечнозеленым.)
желудь - The acorn fell from the oak tree. (Желудь упал с дуба.)
шишка - The cone fell from the pine tree. (Шишка упала с сосны.)
семя - The seed sprouted in the soil. (Семя проросло в почве.)
росток - The sprout grew into a plant. (Росток вырос в растение.)
саженец - The sapling was planted in the garden. (Саженец был посажен в саду.)
ствол - The trunk of the tree was thick. (Ствол дерева был толстым.)
крона - The canopy provided shade. (Крона давала тень.)
поляна - The glade was filled with wildflowers. (Поляна была заполнена полевыми цветами.)
луг - The meadow was full of butterflies. (Луг был полон бабочек.)
долина - The valley was surrounded by mountains. (Долина была окружена горами.)
каньон - The canyon was carved by the river. (Каньон был вырезан рекой.)
утес - The cliff overlooked the ocean. (Утес возвышался над океаном.)
холм - The hill was covered in grass. (Холм был покрыт травой.)
плато - The plateau was flat and vast. (Плато было плоским и обширным.)
равнина - The plain stretched for miles. (Равнина простиралась на мили.)
пустыня - The desert was hot and dry. (Пустыня была жаркой и сухой.)
тундра - The tundra was frozen and barren. (Тундра была замерзшей и бесплодной.)
саванна - The savanna was home to many animals. (Саванна была домом для многих животных.)
джунгли - The jungle was dense and humid. (Джунгли были густыми и влажными.)
болото - The wetland was teeming with life. (Болото кипело жизнью.)
болото - The marsh was filled with reeds. (Болото было заполнено камышом.)
трясина - The swamp was difficult to traverse. (Трясина была труднопроходимой.)
дельта - The delta was formed by the river. (Дельта была образована рекой.)
эстуарий - The estuary was rich with wildlife. (Эстуарий был богат дикой природой.)
лагуна - The lagoon was calm and shallow. (Лагуна была спокойной и мелкой.)
фьорд - The fjord was surrounded by cliffs. (Фьорд был окружен скалами.)
гейзер - The geyser erupted with hot water. (Гейзер извергал горячую воду.)
вулкан - The volcano was dormant. (Вулкан был спящим.)
кратер - The crater was formed by an impact. (Кратер был образован ударом.)
пещера - The cave was dark and mysterious. (Пещера была темной и загадочной.)
родник - The spring provided fresh water. (Родник давал свежую воду.)
ручей - The stream flowed gently. (Ручей течет спокойно.)
ручей - The brook babbled over the rocks. (Ручей журчал над камнями.)
ручей - The creek was lined with trees. (Ручей был окружен деревьями.)
пруд - The pond was home to frogs. (Пруд был домом для лягушек.)
лужа - The puddle reflected the sky. (Лужа отражала небо.)
водопад - The waterfall was breathtaking. (Водопад был захватывающим.)
пороги - The rapids were dangerous to navigate. (Пороги были опасны для прохождения.)
водоворот - The whirlpool pulled everything down. (Водоворот затягивал все вниз.)
прилив - The tide came in quickly. (Прилив наступал быстро.)
волна - The wave crashed on the shore. (Волна разбивалась о берег.)
течение - The current was strong. (Течение было сильным.)
ураган - The hurricane caused widespread damage. (Ураган вызвал массовые разрушения.)
тайфун - The typhoon approached the coast. (Тайфун приближался к побережью.)
циклон - The cyclone brought heavy rain. (Циклон принес сильный дождь.)
торнадо - The tornado destroyed everything in its path. (Торнадо разрушал все на своем пути.)
засуха - The drought lasted for months. (Засуха длилась месяцами.)
наводнение - The flood submerged the town. (Наводнение затопило город.)
град - The hail damaged the crops. (Град повредил урожай.)
мороз - The frost covered the ground. (Мороз покрыл землю.)
роса - The dew glistened in the morning. (Роса сверкала утром.)
туман - The mist rolled in from the sea. (Туман накатывал с моря.)
туман - The fog reduced visibility. (Туман снижал видимость.)
дымка - The haze obscured the view. (Дымка заслоняла вид.)
смог - The smog made it hard to breathe. (Смог затруднял дыхание.)
сумерки - The dusk settled over the landscape. (Сумерки опустились над пейзажем.)
рассвет - The dawn broke over the horizon. (Рассвет занялся над горизонтом.)
сумерки - The twilight was magical. (Сумерки были волшебными.)
восход - The sunrise painted the sky in colors. (Восход раскрасил небо в цвета.)
закат - The sunset was breathtaking. (Закат был захватывающим.)
горизонт - The horizon stretched endlessly. (Горизонт простирался бесконечно.)
зенит - The sun reached its zenith. (Солнце достигло зенита.)
надир - The nadir was opposite the zenith. (Надир был противоположностью зенита.)
экватор - The equator divides the Earth. (Экватор делит Землю.)
полюс - The pole was covered in ice. (Полюс был покрыт льдом.)
полушарие - The hemisphere experienced summer. (Полушарие переживало лето.)
широта - The latitude determined the climate. (Широта определяла климат.)
долгота - The longitude was measured in degrees. (Долгота измерялась в градусах.)
высота - The altitude affected the temperature. (Высота влияла на температуру.)
климат - The climate was tropical. (Климат был тропическим.)
погода - The weather was unpredictable. (Погода была непредсказуемой.)
сезон - The season changed with the months. (Сезон менялся с месяцами.)
весна - The spring brought new life. (Весна приносила новую жизнь.)
лето - The summer was hot and sunny. (Лето было жарким и солнечным.)
осень - The autumn leaves fell. (Осенние листья падали.)
зима - The winter was cold and snowy. (Зима была холодной и снежной.)
солнцестояние - The solstice marked the longest day. (Солнцестояние отмечало самый длинный день.)
равноденствие - The equinox had equal day and night. (Равноденствие имело равные день и ночь.)
муссон - The monsoon brought heavy rain. (Муссон принес сильный дождь.)
бриз - The breeze was refreshing. (Бриз был освежающим.)
шторм - The gale blew fiercely. (Шторм дул яростно.)
порыв - The gust knocked over the chair. (Порыв ветра опрокинул стул.)
зефир - The zephyr was a gentle wind. (Зефир был легким ветерком.)
штиль - The calm was eerie. (Штиль был жутким.)
холод - The chill made us shiver. (Холод заставлял нас дрожать.)
жара - The heat was unbearable. (Жара была невыносимой.)
тепло - The warmth was comforting. (Тепло было утешительным.)
холод - The cold was biting. (Холод был леденящим.)
заморозки - The freeze killed the plants. (Заморозки убили растения.)
оттепель - The thaw melted the ice. (Оттепель растопила лед.)
таять - The ice began to melt. (Лед начал таять.)
испаряться - The water evaporated in the sun. (Вода испарялась на солнце.)
конденсироваться - The steam condensed on the window. (Пар конденсировался на окне.)
осаждаться - The moisture precipitated as rain. (Влага осаждалась в виде дождя.)
влажность - The humidity made the air sticky. (Влажность делала воздух липким.)
засушливый - The arid land was barren. (Засушливая земля была бесплодной.)
влажный - The humid air was heavy. (Влажный воздух был тяжелым.)
тропический - The tropical forest was dense. (Тропический лес был густым.)
умеренный - The temperate zone had four seasons. (Умеренная зона имела четыре сезона.)
полярный - The polar region was freezing. (Полярный регион был замерзшим.)
холодный - The frigid air was biting. (Холодный воздух был леденящим.)
бесплодный - The barren land had no vegetation. (Бесплодная земля не имела растительности.)
плодородный - The fertile soil was perfect for farming. (Плодородная почва была идеальной для земледелия.)
пышный - The lush vegetation was green. (Пышная растительность была зеленой.)
редкий - The sparse trees dotted the landscape. (Редкие деревья усеивали пейзаж.)
густой - The dense forest was hard to navigate. (Густой лес был труднопроходимым.)
дикий - The wild animal roamed freely. (Дикое животное свободно бродило.)
ручной - The tame bird perched on her hand. (Ручная птица сидела на ее руке.)
домашний - The domestic cat purred on the couch. (Домашний кот мурлыкал на диване.)
исчезающий - The endangered species was protected. (Исчезающий вид был защищен.)
вымерший - The extinct animal was only found in fossils. (Вымершее животное находили только в окаменелостях.)
среда обитания - The habitat was destroyed by pollution. (Среда обитания была разрушена загрязнением.)
экосистема - The ecosystem was balanced. (Экосистема была сбалансированной.)
биом - The biome was unique to the region. (Биом был уникальным для региона.)
фауна - The fauna included many species. (Фауна включала множество видов.)
флора - The flora was diverse. (Флора была разнообразной.)
сохранение - Conservation efforts saved the species. (Усилия по сохранению спасли вид.)
загрязнение - Pollution harmed the environment. (Загрязнение вредило окружающей среде.)
эрозия - Erosion washed away the soil. (Эрозия смывала почву.)
вырубка леса - Deforestation destroyed the forest. (Вырубка леса уничтожала лес.)
лесовосстановление - Reforestation helped the environment. (Лесовосстановление помогало окружающей среде.)
устойчивость - Sustainability was key to the future. (Устойчивость была ключом к будущему.)